# Lugonu's bribes, an altar by tgw.
#
# The altar will feature an item which your current god forbids to use
# but which would be useful otherwise (if possible), or an item that is
# just useless/forbidden/redundant under your current god.


NAME:   tgw_lugonu_bribe
DEPTH:  D:12-, Depths
KFEAT:  _ = altar_lugonu

MAP
_
ENDMAP
