# Trog burns a book at his altar.
#
# He only does so if both the altar and the book are in sight of the player.
# This should give sneaky players an opportunity to apport the book, but
# only if they spot the vault in time.


NAME:   trog_book
TAGS:   uniq_altar_trog temple_overflow_trog
DEPTH:  D:2-10, Orc
KFEAT:  _ = altar_trog
KFEAT:  b = .
MAP
xxxxxxx
x.....xxx
x._.b....@
x.....xxx
xxxxxxx
ENDMAP
